[-------------------------]
\                     U   /
\                         /
\       [-------      D   /
\       \     E     S     /
\       \                 /
\       \ C               /
\      e{-------          /
\       E                 /
\C                        /
{-------------------------}