[-------------------------]
\                         /
\                         /
\   D                S    /
\                         /
\                         /
\                         /
\                         /
\                         /
\                         /
{-------------------------}