[--------------]
\              /
\         S    /
\          D   /
\              /
\              /
\   C          /
\              /
{--------------}